# Féminin des substantifs français: Féminin irrégulier.

barman - barmaid
boeuf - vache
cerf - biche
chef - chef,cheffe
cheval - jument
clerc - clergesse
clown - clownesse,clowne
compagnon - compagne
confrère - consoeur
copain - copine
coq - poule
coverboy - covergirl
dieu - déesse
duc - duchesse
empereur - impératrice
filou - filoute
frère - soeur
garçon - fille
gendre - bru
grand-père - grand-mère
héros - héroïne
homme - femme
homme-grenouille - femme-grenouille
mari - femme
monsieur - dame
mouton - brebis
neveu - nièce
oncle - tante
père - mère
parrain - marraine
pizzaiolo - pizzaiola
préfet - préfète
reporter - reporteuse,reportrice
roi - reine
serviteur - servante
sous-chef - sous-chef,sous-cheffe
sous-préfet - sous-préfète
speaker - speakerine
steward (aviation) - hôtesse de l'air
steward (bateau, club) - stewardess
supporter - supportrice
valet - femme de chambre
webmaster - webmistress
